WE ./textures/b.xpm
EA ./textures/c.xpm
NO ./textures/d.xpm
SO ./textures/a.xpm
C 255,255,255
F 220,11,22



1111111111111111111111
111000000000000000000111111111111
1 11111111111111111111
11  1 1111111111111

11111      1
1111111111101111111
1110000000W00000000111
11111111111111111111101
1110000000000000000001
1110000000000000000001
1111111111111111111111